OD: （第一、第二、十六…）
BA: （将、把…）
DER: （得…）
DEV: （地……）
MSP: （而…）
ETC: （等等…）
JJ: 形容词/序数词
DT: 表示限定词（这、那个、所有……）
DEC: (的…)
VE: 有
LB: (被…)
LC: (之后、以来、中、底下…)
NN: 名词
PU: 断句符
NR: 固有名词
DEG: (的…)
PN: 代词
VA: 表语形容词
VC: 是
AD: 副词/形容词短语
CC: 表示连词
M: 数量词？
CD: 表示基数词
P: （因为、根据、在、由于…）
AS: 内容标记（了…）
IJ: （嘿嘿、哈呀、天呐…）
VV: 动词
CS: （虽然、要是、不管、只要…）
ON: （呵呵…）
NT: 时间名词
SP: （的啦、的、呀…）
SB: ？
